{
	"width": 10,
	"height": 10,
	"level": [[ 1, 1, 1, 1, 1, 1, 1, 1, 1, 1 ],
			  [ 1, 0, 0, 0, 1, 0, 0, 0, 0, 1 ],
			  [ 1, 0, 0, 0, 1, 0, 0, 0, 0, 1 ],
			  [ 1, 0, 0, 0, 1, 0, 0, 0, 0, 1 ],
			  [ 1, 0, 1, 0, 1, 0, 0, 1, 0, 1 ],
			  [ 1, 0, 1, 0, 0, 0, 0, 1, 0, 1 ],
			  [ 1, 0, 0, 0, 0, 0, 0, 1, 0, 1 ],
			  [ 1, 0, 0, 0, 0, 1, 0, 1, 0, 1 ],
			  [ 1, 0, 0, 0, 0, 0, 0, 1, "s", 1 ],
			  [ 1, 1, 1, 1, 1, 1, 1, 1, 1, 1 ]]
}